25 20
13 10

2 2 2 2 2 2 2 2 2 2 2 2 2 2 2 2 2 2 2 2 0 1 2 3 4
2 1 1 1 1 1 1 1 1 2 2 1 1 1 1 1 1 1 1 2 0 1 2 3 4
2 1 0 0 0 0 0 4 1 2 2 1 0 0 0 0 0 4 1 2 0 1 2 3 4
2 1 0 0 0 0 0 0 1 2 2 1 0 0 0 0 0 0 1 2 0 1 2 3 4
2 1 0 0 3 3 0 0 1 2 2 1 0 0 3 3 0 0 1 2 0 1 2 3 4
2 1 0 0 3 3 0 0 1 2 2 1 0 0 3 3 0 0 1 2 0 1 2 3 4
2 1 0 0 0 0 0 0 1 2 2 1 0 0 0 0 0 0 1 2 0 1 2 3 4
2 1 0 0 0 0 0 0 1 2 2 1 0 0 0 0 0 0 1 2 0 1 2 3 4
2 1 1 1 1 1 1 1 5 2 2 1 1 1 1 1 1 1 5 2 0 1 2 3 4
2 2 2 2 2 2 2 2 2 2 2 2 2 2 2 2 2 2 2 2 0 1 2 3 4
2 2 2 2 2 2 2 2 2 2 2 2 2 2 2 2 2 2 2 2 0 1 2 3 4
2 1 1 1 1 1 1 1 1 2 2 1 1 1 1 1 1 1 1 2 0 1 2 3 4
2 1 0 0 0 0 0 4 1 2 2 1 0 0 0 0 0 4 1 2 0 1 2 3 4
2 1 0 0 0 0 0 0 1 2 2 1 0 0 0 0 0 0 1 2 0 1 2 3 4
2 1 0 0 3 3 0 0 1 2 2 1 0 0 3 3 0 0 1 2 0 1 2 3 4
2 1 0 0 3 3 0 0 1 2 2 1 0 0 3 3 0 0 1 2 0 1 2 3 4
2 1 0 0 0 0 0 0 1 2 2 1 0 0 0 0 0 0 1 2 0 1 2 3 4
2 1 0 0 0 0 0 0 1 2 2 1 0 0 0 0 0 0 1 2 0 1 2 3 4
2 1 1 1 1 1 1 1 5 2 2 1 1 1 1 1 1 1 5 2 0 1 2 3 4
2 2 2 2 2 2 2 2 2 2 2 2 2 2 2 2 2 2 2 2 0 1 2 3 4